3
16
16
Town.png
TerraWalk.png
SetzerWalk.png
10
10
0,3,  0,4,  0,4,  0,4,  0,4,  0,4,  0,4,  0,4,  0,4,  0,5,
0,19, 0,20, 0,20, 0,20, 0,51, 0,53, 0,20, 0,20, 0,20, 0,21,
0,19, 0,20, 0,20, 0,51, 0,17, 0,69, 0,20, 0,20, 0,20, 0,21,
0,19, 0,20, 0,20, 0,20, 0,67, 0,69, 0,20, 0,20, 0,20, 0,21,
0,19, 0,20, 0,20, 0,20, 0,67, 0,69, 0,20, 0,20, 0,20, 0,21,
0,19, 0,20, 0,20, 0,20, 0,67, 0,69, 0,20, 0,20, 0,20, 0,21,
0,19, 0,20, 0,20, 0,20, 0,67, 0,69, 0,20, 0,20, 0,20, 0,21,
0,19, 0,20, 0,20, 0,51, 0,84, 0,84, 0,53, 0,20, 0,20, 0,21,
0,35, 0,36, 0,36, 0,36, 0,36, 0,36, 0,36, 0,36, 0,36, 0,37,
1,1,  1,6,  1,13, 2,1,  2,6,  2,10, 2,13, 0,0,  0,0,  0,10
